32 32
1 1
2 2 2 2 2 2 2 2 2 2 2 2 2 2 2 2 2 2 2 2 2 2 2 2 2 2 2 2 94 95 96 2
21 0 0 0 3 3 3 4 0 0 0 0 81 82 83 11 11 21 11 11 11 11 11 11 11 11 11 11 97 98 99 22
21 0 0 0 3 3 3 4 0 0 0 0 84 85 86 11 11 21 11 11 11 11 11 11 11 11 11 11 11 11 11 22
21 0 0 0 3 3 3 4 0 0 0 0 87 88 89 11 11 21 11 11 11 11 11 11 11 11 11 11 11 11 11 22
21 0 0 0 3 3 3 4 0 0 0 0 0 0 0 11 11 21 91 92 93 11 11 11 11 91 92 93 91 92 93 22
21 0 0 0 7 8 9 11 11 11 11 11 11 11 11 11 11 21 94 95 96 11 50 11 11 94 95 96 94 95 96 22
21 0 0 0 7 8 9 11 11 11 11 11 11 11 11 11 11 21 97 98 99 11 51 11 11 97 98 99 97 98 99 22
21 3 3 3 3 3 3 4 11 11 0 0 0 0 0 11 11 21 11 11 11 11 11 11 11 11 11 11 11 11 11 22
21 3 3 3 3 3 3 4 11 11 0 91 92 93 0 11 11 21 11 11 11 11 11 11 11 11 11 11 11 11 11 22
21 4 4 4 4 4 4 4 11 11 0 94 95 96 0 11 11 21 91 92 93 11 11 11 11 91 92 93 91 92 93 22
21 4 4 4 4 4 0 0 11 11 0 97 98 99 0 11 11 21 94 95 96 11 11 11 11 94 95 96 94 95 96 22
21 4 4 4 0 0 0 0 11 11 0 0 0 0 0 11 11 21 97 98 99 11 11 11 11 97 98 99 97 98 99 22
21 4 4 0 0 0 0 0 11 11 11 11 11 11 11 11 11 21 11 11 11 11 11 11 11 11 11 11 11 11 11 22
21 4 4 4 0 0 0 0 11 11 11 11 11 11 11 11 11 2 2 2 2 2 11 11 2 2 2 2 2 2 2 2
21 4 4 0 0 0 0 0 11 11 11 11 11 11 11 11 11 11 50 11 11 11 11 11 11 11 11 11 11 11 11 22
21 4 4 4 0 0 0 0 11 11 11 11 11 11 11 11 11 11 51 11 11 11 11 11 11 11 11 11 11 11 11 22
21 0 0 4 0 0 0 0 11 11 11 11 11 11 11 11 11 81 82 83 81 82 83 81 82 83 81 82 83 0 0 22
21 0 0 4 0 0 4 4 4 4 4 11 11 11 11 11 11 84 85 86 84 85 86 84 85 86 84 85 86 0 0 22
21 4 4 4 0 0 4 3 3 3 4 11 11 11 11 11 11 87 88 89 87 88 89 87 88 89 87 88 89 0 0 22
21 3 4 4 40 41 4 3 3 3 4 0 0 0 0 11 11 0 0 0 0 0 0 0 0 0 0 0 0 0 0 22
21 3 4 4 4 4 4 3 3 3 4 0 0 0 0 11 11 81 82 83 81 82 83 81 82 83 81 82 83 0 0 22
21 3 3 3 3 3 3 3 3 3 4 0 0 0 0 11 11 84 85 86 84 85 86 84 85 86 84 85 86 40 41 22
21 3 3 3 3 3 3 3 3 3 4 0 0 0 0 11 11 87 88 89 87 88 89 87 88 89 87 88 89 0 0 22
21 3 3 3 3 3 3 3 3 3 4 0 0 0 0 11 11 81 82 83 81 82 83 81 82 83 40 41 0 0 0 22
21 4 4 4 4 4 4 4 4 4 4 0 0 0 0 11 11 84 85 86 84 85 86 84 85 86 6 6 0 0 0 22
21 4 4 4 4 4 4 4 4 4 4 0 0 0 0 11 11 87 88 89 87 88 89 87 88 89 6 6 0 0 0 22
21 11 11 0 0 0 0 0 0 0 0 0 11 11 11 11 11 0 0 0 0 10 10 0 0 0 6 6 0 0 0 22
21 11 11 0 0 0 0 0 0 0 0 0 11 11 11 11 11 0 0 0 0 10 10 0 0 0 6 6 0 0 0 22
21 11 11 11 11 11 11 11 11 11 11 11 11 11 11 11 11 6 6 6 6 6 6 6 6 6 6 6 0 0 0 22
21 11 11 11 11 11 11 11 11 11 11 11 11 11 11 11 11 6 6 6 6 6 6 6 6 6 6 6 0 0 0 22
21 11 11 40 41 0 0 0 0 0 0 0 0 0 0 11 11 0 0 0 0 0 0 0 0 10 10 0 0 0 0 22
21 2 2 2 2 2 2 2 2 2 2 2 2 2 2 2 2 2 2 2 2 2 2 2 2 2 2 2 2 2 2 2

